РЕКЛАМА

Эльторин


Народы <Эльторина>:
1. Гномы
2. Драконы
3. Кентавры
4. Люди
5. Нимфы
6. Оборотни
7. Ольты
8. Русалки
9. <Тагги>
10. <Тролли> (на момент описанных событий в книге эта раса была уничтожена)
11. Эльфы
Королевства:
1. Королевство эльфов <Вальдорн>
2. Королевство людей <Радагар>
3. Калангорский лес, столица — Донгесс, — владения оборотней
4. Королевство Великих Озёр — Королевство ольтов (дети воды и <Алантиль>, предсказатели будущего)
Основные персонажи:
1. Оборотни:
-Халлис Храбрый — Владыка оборотней, отец <Хельды> (белый леопард)
-Даяна Мудрая — Владычица оборотней, мать <Хельды> (куница)
-Хельда Спасительница — Владычица оборотней (роглион)
-Берганн — придворный <Учитель>, наставник <Хельды> (конь)
-Тиллан — военачальник <Калангора>, правая рука <Владыки> (тигр)
-Ильта — кормилица <Хельды> (кошка)
-Аника — ученица <Тиллана> (рысь)
-Галлад — ученик <Тиллана> (гепард)
-Гирэлл — страж <Владычицы> (сокол)
-Даннол — личный помощник <Владычицы> (лис)
-Наллит — страж <Владычицы> (орёл)
-Тальра — служанка (хорёк)
-Теннет — воин (белый голубь)
-Торрат — страж <Владычицы> (филин)
-Фаллар — ученик <Тиллана> (конь)
-Хайввар — Глава Совета Донгесса (сова)
-Мэллот — кузнец (бурый медведь)
-Шаккет — воин (уж)
-Сайттин — советник (горностай)
-Нетлина - (колибри)
2. Нимфы:
-Кальта — посол народа нимф
3. <Тагги>:
-Лират — говорящая таггов (рыжая сова)
-Онго — друг <Аники> (синий филин)
-Дарга — ярко-красная сова
4. Кентавры:
-Хагир — вожак кентавров Южного континента
-Арта — целительница кентавров
-Дакрог — вожак кентавров, отец <Хагира>
5. Эльфы:
-Аэлиантар Вирендил — Король эльфов
-Арлиавин <Имрас Вирендил> — Королева эльфов
-Надритэль — эльф-хранитель библиотеки <Вальдорна>.
-Дейлас — эльф, наставник магии.
-Каелон Тэниэль — эльф, страж границ <Вальдорна>. (лучник-хранитель)
-Ваолин — эльфийка из отряда магов
-Ристэль — эльф из отряда магов
-Ларг — эльф из отряда магов
-Таэлас — эльф из отряда магов
6. Ольты:
-Нэмиль — король ольтов (зелёное сердце)
-Валлен — дальен (жрица) ольтов (жёлто-оранжевое сердце)
7. Люди:
-Сангол Воитель — король людей
-Горт — архимаг
-Мограт — воин, летописец
<Термины>:
1. <Алантиль> — священная звезда ольтов
2. <Анга> — уважительное обращение к Владычицей
3. <Бухта Мэливей> — морская граница <Калангора>
4. Лирр — бодрящий напиток из заваренных листьев одноимённого растения
5. Пирг — целебное растение со светящимися в темноте цветами
6. Рантан — первый спутник <Эльторина> — <Остроглазый Ястреб>
7. <Эндавиен> — второй спутник <Эльторина> — Серебряная Волчица
8. Ажурные деревья — деревья эльфов
9. Тарты — один из видов драконов.
10. Роглионы — высшие драконы.
11. Анубри — цепь гор, в которых по преданиям жили драконы.